000000000010010000000000000000
000000000001100000000000010000
000000000000000000000000010000
000000001111000000000000010000
000000000000000000000001000000
000000000000100000000000110000
000000000001110000000000001000
000000000000100000000000000000
000000000000000000000000000000
000000000000000000000000000000